{
  "name": "Przykładowy Labirynt",
  "width": 15,
  "height": 15,
  "maze": [
    [1,1,1,1,1,1,1,1,1,1,1,1,1,1,1],
    [1,0,0,0,1,0,0,0,0,0,1,0,0,0,1],
    [1,0,1,0,1,0,1,1,1,0,1,0,1,0,1],
    [1,0,1,0,0,0,0,0,1,0,0,0,1,0,1],
    [1,0,1,1,1,1,1,0,1,1,1,1,1,0,1],
    [1,0,0,0,0,0,0,0,0,0,0,0,0,0,1],
    [1,1,1,0,1,1,1,1,1,1,1,0,1,1,1],
    [1,0,0,0,0,0,0,0,0,0,0,0,0,0,1],
    [1,0,1,1,1,0,1,1,1,0,1,1,1,0,1],
    [1,0,0,0,1,0,0,0,0,0,1,0,0,0,1],
    [1,1,1,0,1,1,1,0,1,1,1,0,1,1,1],
    [1,0,0,0,0,0,0,0,0,0,0,0,0,0,1],
    [1,0,1,1,1,1,1,1,1,1,1,1,1,0,1],
    [1,0,0,0,0,0,0,0,0,0,0,0,0,0,1],
    [1,1,1,1,1,1,1,1,1,1,1,1,1,1,1]
  ],
  "startPos": {
    "x": 1,
    "y": 1
  },
  "endPos": {
    "x": 13,
    "y": 13
  },
  "created": "2025-06-03T12:00:00.000Z",
  "version": "1.0"
}
